11111111111111111111111111111111111111111111
1P1CCC1110000000000011C001100000000VSCS000E1
101CCC1110000000010011C10110SSSSSS0000S00001
1010000000000000010011C10110SSSSSSSSSSS00001
100001S0S0000000010011C1001000V000V000V00001
111011S0S0000000010011111000100V000V000V0001
100011S0S11111111000H1VV11011000V000V000V001
101111S0S1HV11111H000100100110000V000V000V01
1C1111SCS1VH11111100000000111V0000V000V000V1
11111111111111111111111111111111111111111111
