11111111111111111111111111111111111111111111111111111111111111111111111111
10000000011111111111111111111111111111111111111111111111111111111111111111
11111011011111111111111111111111111111111111111111111111111111111111111111
10V0C001001111111111111111111111111111111111111111111111111111111111111111
1P00SS01C01111111111111111111111111111111111111111111111111111111111111111
1SS0SSSSSS1111111111111111111111111111111111111111111111111111111111111111
100000E0001111111111111111111111111111111111111111111111111111111111111111
11000000001111111111111111111111111111111111111111111111111111111111111111
11000000001111111111111111111111111111111111111111111111111111111111111111
110000000s1111111111111111111111111111111111111111111111111111111111111111
11111111111111111111111111111111111111111111111111111111111111111111111111
