11111111111
1E000000011
11110001011
1000C001011
1P000001C11
11111111111
