1111111111111111111111111111111111
1E00000000000000000000000000001C01
1100000000000000000C00000000101001
1000C00000000000000000000000101011
1P000000000000000000000000001000C1
1111111111111111111111111111111111
