11111
1EP01
11111
10C01
11111
