11111
1P0C1
11111
10E01
11111
