11111111111
1000V000011
11110H01011
10V0C001011
10000SS1C11
11110111111
1111H111111
11C0P0E1111
11111111111
